2 2 2 2 2 2 2 2 2 2 2 2 2 2 2 2 2 2 2 2 2 2 2 2 2
2 0 0 0 0 2 0 0 0 0 0 0 2 0 0 0 0 0 0 2 0 0 0 0 2
2 2 0 0 2 2 0 0 0 0 0 0 2 0 0 1 0 0 0 2 0 0 0 0 3
2 0 0 0 0 0 0 0 0 9 0 0 2 0 5 0 0 0 0 0 0 0 0 0 2
2 0 0 9 0 2 0 0 5 0 0 0 2 0 0 0 0 0 0 0 0 0 0 0 2
2 0 6 0 0 2 0 0 0 0 0 0 0 0 0 0 0 0 0 2 0 0 0 0 2
2 2 0 0 2 2 2 2 0 0 2 2 2 2 0 0 2 2 2 2 2 2 0 2 2
2 0 0 0 0 2 0 0 0 0 0 0 2 0 9 0 0 0 0 2 6 6 6 6 2
2 0 0 0 0 2 0 0 2 2 2 2 2 0 0 0 0 10 0 2 5 5 5 5 2
2 0 9 5 0 2 0 0 2 0 0 0 2 0 0 0 9 0 0 2 6 6 6 0 2
2 0 0 5 0 2 0 9 2 0 0 0 2 0 0 0 0 0 0 2 5 5 5 0 2
2 0 0 0 0 0 0 0 2 0 0 0 2 0 0 0 0 0 0 2 0 0 0 0 2
2 2 0 0 2 2 2 2 2 2 2 0 2 2 2 0 0 2 0 2 2 2 2 2 2
2 2 0 0 0 2 0 0 0 0 0 0 2 0 0 0 0 0 0 2 0 0 0 0 2
2 0 5 0 0 2 0 0 0 0 0 0 2 0 0 0 0 4 4 2 0 0 0 0 2
2 0 5 0 0 0 0 0 0 0 0 0 0 0 0 0 4 4 0 0 0 0 0 0 2
2 0 5 0 0 0 0 0 0 0 0 0 0 0 0 0 4 0 4 2 2 2 2 0 2
2 0 0 0 0 0 0 0 0 0 0 0 0 0 0 0 4 0 0 0 0 0 0 0 2
2 0 0 0 0 2 0 0 0 0 0 9 0 0 0 0 4 4 4 2 0 5 0 0 2
2 0 0 0 0 2 0 0 0 0 0 0 2 0 0 0 0 0 0 2 0 0 0 0 2
4 2 0 0 0 2 2 2 0 0 0 2 2 2 0 2 2 2 0 2 2 0 2 2 2
4 0 0 0 0 2 0 0 0 0 0 0 2 0 0 0 0 0 0 2 0 0 0 0 2
4 0 8 0 0 2 0 9 0 0 5 0 2 0 0 0 0 0 0 2 0 0 0 0 2
2 0 0 0 0 2 0 0 0 0 0 0 2 0 0 0 0 0 0 2 0 0 0 0 2
2 2 2 2 2 2 2 2 2 2 2 2 2 2 2 2 2 2 2 2 2 2 2 2 2
