2 2 2 2 2 2 2 2 2 2 2 2 3 2 2 2 2 2 2 2 2 2 2 2 2
2 0 0 0 0 0 0 0 0 0 0 0 0 0 0 0 0 0 0 0 0 0 0 0 2
2 2 2 2 2 2 2 2 2 2 0 0 0 0 0 2 2 2 2 2 2 2 2 2 2
2 2 2 2 0 2 2 2 2 2 0 0 0 0 0 2 2 0 0 0 0 0 0 2 2
2 0 0 0 0 2 2 2 2 2 0 9 9 0 0 0 0 0 4 4 4 4 0 2 2
2 0 0 2 0 2 2 2 2 2 0 0 9 0 0 2 2 0 0 0 0 0 0 2 2
2 9 9 2 10 2 2 2 2 2 0 0 0 0 0 2 2 2 2 2 2 2 2 2 2
2 2 2 2 0 2 2 2 2 2 0 0 0 0 0 2 2 2 2 2 2 2 2 2 2
2 2 2 2 0 2 2 2 2 2 0 0 0 0 0 2 2 2 2 2 2 2 2 2 2
2 2 0 0 0 0 0 0 2 2 0 0 0 0 0 10 2 0 0 8 0 0 0 2 2
2 2 14 0 0 0 5 0 2 2 0 0 0 0 10 2 2 0 0 0 9 0 0 2 2
2 2 14 14 7 0 0 0 2 2 0 4 0 4 0 2 2 0 0 0 8 0 0 2 2
2 2 0 0 0 0 6 0 0 0 0 0 0 0 0 0 0 0 9 0 1 0 0 2 2
2 2 0 0 0 0 0 0 2 2 0 4 0 4 0 2 2 0 0 0 0 0 0 2 2
2 2 2 2 2 2 2 2 2 2 0 0 0 0 0 2 2 0 0 0 9 0 0 2 2
2 2 2 2 2 2 2 2 2 2 0 2 2 2 2 2 2 2 2 2 2 2 2 2 2
2 2 2 2 2 2 2 2 2 2 0 2 2 2 2 2 2 2 2 2 2 2 2 2 2
2 2 2 2 2 2 2 2 2 2 0 2 2 2 2 2 2 2 2 2 2 2 2 2 2
2 2 2 2 2 2 2 2 2 0 0 0 0 0 0 0 2 2 2 2 2 2 2 2 2
2 2 2 2 2 2 2 2 2 0 0 0 0 0 0 0 2 2 2 2 2 2 2 2 2
2 2 0 0 0 0 5 0 0 0 0 0 9 0 0 0 2 2 2 2 2 2 2 2 2
2 2 0 8 0 0 0 0 10 2 0 0 0 0 0 0 10 2 2 2 2 2 2 2 2
2 2 0 0 0 0 0 0 2 2 0 0 0 0 5 0 2 2 2 2 2 2 2 2 2
2 2 2 2 2 2 2 2 2 2 2 2 2 2 2 2 2 2 2 2 2 2 2 2 2
2 2 2 2 2 2 2 2 2 2 2 2 2 2 2 2 2 2 2 2 2 2 2 2 2
