2 2 2 2 2 2 2 2 2 2 2 2 2 2 2 2 2 2 2 2 2 2 2 2 2
2 0 0 0 0 0 0 0 0 0 0 0 0 0 0 0 0 0 0 0 10 0 0 0 2
2 10 0 0 0 0 0 0 2 0 0 0 0 0 0 0 2 0 0 0 10 0 6 0 2
2 0 0 4 0 4 0 0 2 0 0 0 0 0 0 0 2 0 0 0 10 5 0 0 2
2 0 0 0 1 0 0 0 0 0 0 0 10 0 0 14 2 0 0 0 0 0 0 0 2
2 0 0 4 0 4 0 0 2 0 0 0 0 0 0 14 2 0 0 0 0 0 0 0 2
2 0 6 0 0 0 9 0 2 0 0 0 0 0 9 14 0 0 0 0 0 0 0 0 2
2 0 0 0 0 0 0 0 2 0 0 0 0 0 14 0 2 0 0 0 9 0 0 0 2
2 0 0 0 0 2 2 2 2 2 2 10 0 2 2 2 2 2 2 2 2 0 0 0 2
2 0 0 0 0 0 0 0 2 14 0 0 0 0 0 0 2 0 0 0 0 0 0 0 2
2 0 5 0 0 0 9 0 2 14 14 0 0 0 0 0 2 0 9 0 0 0 0 0 2
2 0 0 0 0 0 0 0 2 0 0 4 0 4 0 0 2 0 0 0 0 0 0 0 2
2 0 11 0 0 9 0 0 2 0 0 0 7 0 0 9 2 0 0 0 5 6 9 0 3
2 0 0 0 0 0 0 0 2 0 0 4 0 4 0 0 2 0 0 0 0 0 0 0 2
2 0 0 0 0 0 9 0 2 0 9 0 0 0 0 0 0 0 0 0 0 0 5 0 2
2 0 0 0 0 0 0 0 2 0 0 0 0 0 0 0 2 0 0 0 0 0 0 0 2
2 0 0 0 0 0 2 2 0 2 2 2 2 2 0 2 2 2 2 2 2 0 0 0 2
2 0 0 0 0 0 0 0 2 0 0 0 0 0 0 0 2 0 0 0 0 0 0 0 2
2 0 0 0 0 0 9 0 2 0 0 0 0 0 9 0 0 0 0 0 0 0 6 0 2
2 0 0 0 0 0 0 0 2 0 0 0 0 0 0 0 2 0 0 4 0 4 0 0 2
2 0 0 0 0 0 0 0 2 0 9 0 0 0 0 0 2 0 9 0 0 0 0 0 2
2 0 0 0 0 0 0 0 2 0 0 0 0 0 0 0 2 0 0 4 0 4 0 0 2
2 0 8 0 0 0 0 0 0 0 0 0 0 0 0 0 2 0 0 0 0 0 0 0 2
2 2 2 2 2 2 2 2 2 2 2 2 2 2 2 2 2 2 2 2 2 2 2 2 2
2 2 2 2 2 2 2 2 2 2 2 2 2 2 2 2 2 2 2 2 2 2 2 2 2
