2 2 2 2 2 2 2 2 2 2 2 2 3 2 2 2 2 2 2 2 2 2 2 2 2
2 0 0 0 0 0 0 0 0 0 0 0 0 0 0 0 0 0 0 0 0 0 0 0 2
2 2 2 2 2 2 2 2 2 2 0 0 2 0 2 2 2 2 0 2 2 2 0 15 2
2 2 0 0 0 0 0 2 0 5 0 0 2 0 2 9 0 2 2 2 2 2 0 2 2
2 2 0 16 0 0 0 2 0 0 0 0 2 0 2 0 0 2 2 2 2 10 0 2 2
2 2 0 0 0 0 0 0 0 0 0 0 0 0 0 0 0 0 0 0 0 0 0 2 2
2 2 2 2 2 0 2 2 2 2 2 2 0 2 2 2 2 0 0 2 2 2 2 2 2
2 0 0 0 0 0 0 0 0 0 0 10 2 0 0 0 0 0 0 0 0 0 0 0 2
2 0 0 0 0 0 0 0 0 0 0 2 2 9 0 0 0 6 0 0 0 0 0 0 2
2 0 0 4 4 0 0 14 0 0 0 2 2 0 0 0 0 0 0 0 4 4 0 0 2
2 0 0 4 4 0 0 14 0 0 10 2 2 0 0 0 0 0 0 0 4 4 0 0 2
2 0 0 0 0 0 9 14 0 0 0 2 2 0 0 0 0 9 0 0 10 0 0 0 2
2 0 0 0 0 0 0 14 0 0 0 2 0 0 0 0 0 0 0 0 0 0 0 0 2
2 2 2 2 2 2 2 2 2 0 2 2 0 2 2 0 2 2 2 2 2 2 2 0 2
2 0 0 0 0 0 0 0 0 0 2 2 0 0 0 0 2 2 0 0 0 0 0 0 2
2 0 0 0 0 5 0 0 0 0 2 2 0 0 0 15 2 2 0 0 0 0 0 0 2
2 0 0 0 9 0 0 0 0 0 2 2 0 0 0 0 2 2 9 0 0 0 0 0 2
2 0 0 0 0 0 10 0 0 0 2 2 0 0 0 0 2 2 0 0 0 0 0 0 2
2 2 2 2 2 2 2 2 2 2 2 2 0 2 2 2 2 2 2 2 0 2 2 2 2
2 0 0 0 0 0 0 0 0 0 0 0 0 0 0 0 0 0 0 0 0 0 0 0 2
2 0 0 0 0 0 14 14 14 0 0 0 0 0 0 0 0 0 0 0 0 0 14 0 2
2 0 8 0 0 0 0 1 0 9 0 0 0 0 10 0 0 9 0 0 0 0 0 10 2
2 0 0 0 0 0 0 0 0 0 0 0 0 0 0 0 0 0 0 0 0 10 1 0 2
2 2 2 2 2 2 2 2 2 2 2 2 2 2 2 2 2 2 2 2 3 2 2 2 2
