2 2 2 2 2 2 2 2 2 2 2 2 2 2 2 2 2 2 2 2 2 2 3 2 2
2 0 0 0 0 0 0 0 2 0 0 0 0 0 0 0 2 0 0 0 0 0 0 0 2
2 0 15 0 0 0 0 0 2 0 0 0 0 0 0 0 2 0 0 0 0 0 0 0 2
2 0 0 0 9 0 10 0 2 0 0 0 0 0 0 0 2 0 0 0 10 0 9 0 2
2 0 0 0 0 14 14 14 14 14 14 0 0 0 0 0 0 0 0 0 0 0 0 0 2
2 0 0 0 0 14 0 0 2 0 0 0 0 0 0 0 2 0 0 0 0 0 0 0 2
2 0 0 0 0 0 0 0 2 0 0 0 0 0 0 0 2 0 0 0 0 0 0 0 2
2 0 0 0 10 0 0 0 2 0 0 0 0 0 0 0 2 0 0 0 9 0 0 0 2
2 2 2 2 0 2 2 2 2 0 2 2 0 2 2 2 2 2 2 2 0 2 2 2 2
2 0 0 0 0 0 0 0 2 0 4 4 4 4 4 0 2 0 0 0 0 0 0 0 2
2 0 0 0 0 0 0 0 2 0 4 0 9 0 4 0 2 0 0 0 0 0 0 0 2
2 0 0 0 0 0 0 0 2 0 4 0 0 0 4 0 2 0 0 0 0 0 0 0 2
2 0 0 9 0 10 0 0 0 0 0 0 1 0 0 0 0 0 9 0 10 0 9 0 2
2 0 0 0 0 0 0 0 2 0 4 0 0 0 4 0 2 0 0 0 0 0 0 0 2
2 0 0 0 0 0 0 0 2 0 4 4 4 4 4 0 2 0 0 0 0 0 0 0 2
2 0 0 0 0 0 0 0 2 0 0 0 0 0 0 0 2 0 0 0 0 0 0 0 2
2 2 2 2 2 2 2 2 2 2 2 2 0 2 2 2 2 2 2 2 2 2 2 2 2
2 0 0 0 0 0 0 0 2 0 0 0 0 0 0 0 2 0 0 0 0 0 0 0 2
2 0 5 0 0 0 0 0 2 0 0 0 0 0 0 0 2 0 0 0 0 0 0 0 2
2 0 0 0 10 0 0 0 2 0 0 0 0 0 0 0 2 0 0 0 0 0 0 0 2
2 0 0 0 0 0 0 0 2 0 0 0 0 0 0 0 2 0 0 0 0 0 0 0 2
2 0 0 0 0 0 1 0 2 0 0 0 0 0 0 0 2 0 0 0 0 0 0 0 2
2 0 8 0 0 0 0 0 0 0 0 0 0 0 0 0 2 0 0 0 0 0 0 0 2
2 2 2 2 2 2 2 2 2 2 2 2 2 2 2 2 2 2 2 2 2 2 2 2 2
