2 2 2 2 2 2 2 2 2 2 2 2 3 2 2 2 2 2 2 2 2 2 2 2 2
2 0 0 0 0 0 0 0 0 0 0 0 0 0 0 0 0 0 0 0 0 0 0 0 2
2 2 2 2 2 2 2 2 2 2 0 15 15 15 0 2 2 2 2 2 2 2 2 2 2
2 2 0 0 0 0 0 2 0 0 0 0 0 0 0 2 0 0 0 0 0 0 0 2 2
2 2 0 1 0 0 0 0 0 0 0 0 0 0 0 0 0 0 0 0 0 0 0 2 2
2 2 0 0 0 0 0 2 0 0 0 0 0 0 0 2 0 0 0 0 0 0 0 2 2
2 2 2 2 2 2 2 2 2 2 2 2 0 2 2 2 2 2 2 2 2 2 2 2 2
2 0 0 0 0 0 2 0 0 0 0 0 0 0 0 0 0 0 2 0 0 0 0 0 2
2 0 0 0 0 0 2 0 0 9 0 0 0 0 0 10 0 0 2 0 0 0 0 0 2
2 0 0 0 0 0 2 0 0 0 0 0 15 0 0 0 0 0 2 0 0 0 0 0 2
2 0 0 0 0 0 2 0 0 0 0 0 0 0 0 0 0 0 2 0 10 0 0 0 2
2 0 0 0 0 0 2 0 0 0 10 0 0 0 0 0 0 0 0 0 0 0 0 0 2
2 0 0 0 0 0 0 0 0 0 0 0 13 0 0 0 0 0 2 0 0 0 10 0 2
2 0 0 0 0 0 2 0 0 0 0 0 15 0 0 0 0 0 2 0 0 0 0 0 2
2 0 0 0 0 0 2 0 0 0 0 0 0 0 0 0 0 0 2 0 10 0 0 0 2
2 0 0 0 0 0 2 0 0 10 0 0 0 0 0 0 0 0 2 0 0 0 10 0 2
2 0 0 0 0 0 2 0 0 0 0 0 0 0 0 0 0 0 2 0 9 0 0 0 2
2 0 0 0 0 0 2 0 0 0 0 0 0 0 0 0 0 0 2 0 0 0 0 0 2
2 2 2 2 2 2 2 2 2 2 2 2 0 2 2 2 2 2 2 2 2 2 2 2 2
2 0 0 0 0 0 0 0 0 0 0 0 0 0 0 0 0 0 0 0 0 0 0 0 2
2 0 6 0 6 0 14 0 0 0 0 0 0 0 0 0 0 0 0 0 15 15 15 0 2
2 0 0 0 0 0 0 0 0 9 0 10 0 9 0 10 0 0 0 0 0 0 0 0 2
2 0 8 0 0 0 0 0 0 0 0 0 0 0 0 0 0 0 0 0 0 0 0 0 2
2 2 2 2 2 2 2 2 2 2 2 2 2 2 2 2 2 2 2 2 2 2 2 2 2
